word,FREQcount,Lg10WF,CDcount,Lg10CD,Dom_PoS_SUBTLEX,Percentage_dom_PoS,animacy_mental_rating,animacy_physical_rating,total_animacy
captain,10622,4.0262,1785,3.2519,Noun,1.00,662,690,1352
biologist,64,1.8129,50,1.7076,Noun,0.97,670,680,1350
surgeon,838,2.9238,500,2.6998,Noun,1.00,678,668,1346
governor,1369,3.1367,401,2.6042,Noun,0.98,683,656,1339
dentist,571,2.7574,294,2.4698,Noun,1.00,661,676,1337
father,28279,4.4515,5446,3.7362,Noun,1.00,658,679,1337
scientist,621,2.7938,397,2.5999,Noun,1.00,672,665,1337
woman,22166,4.3457,5925,3.7728,Noun,1.00,647,690,1337
leader,1589,3.2014,894,2.9518,Noun,0.99,700,634,1334
orthodontist,25,1.415,20,1.3222,Noun,1.00,672,661,1333
engineer,596,2.776,326,2.5145,Noun,0.95,693,638,1331
detective,3117,3.4939,988,2.9952,Noun,0.99,685,645,1330
mother,24476,4.3888,5556,3.7448,Noun,0.99,641,685,1326
chef,606,2.7832,322,2.5092,Noun,1.00,651,672,1323
dad,25870,4.4128,4351,3.6387,Noun,1.00,659,664,1323
preacher,342,2.5353,145,2.1644,Noun,0.99,668,651,1319
parent,670,2.8267,475,2.6776,Noun,1.00,651,667,1318
boss,6339,3.8021,2333,3.3681,Noun,0.95,641,674,1315
actress,817,2.9128,379,2.5798,Noun,1.00,640,673,1313
supervisor,304,2.4843,240,2.382,Noun,0.99,660,653,1313
athlete,235,2.3729,189,2.2788,Noun,1.00,651,658,1309
lady,11071,4.0442,4129,3.616,Noun,1.00,614,695,1309
person,10857,4.0357,4712,3.6733,Noun,1.00,637,672,1309
author,405,2.6085,251,2.4014,Noun,0.99,658,650,1308
sergeant,3210,3.5066,798,2.9025,Noun,1.00,656,652,1308
employee,590,2.7716,429,2.6335,Noun,1.00,625,682,1307
soldier,1985,3.298,830,2.9196,Noun,1.00,654,652,1306
electrician,76,1.8865,59,1.7782,Noun,1.00,642,658,1300
emperor,690,2.8395,184,2.2672,Noun,1.00,651,649,1300
writer,1200,3.0795,573,2.7589,Noun,1.00,648,652,1300
sheriff,3115,3.4936,662,2.8215,Noun,0.99,657,641,1298
banker,243,2.3874,160,2.2068,Noun,1.00,640,656,1296
people,56252,4.7501,7889,3.8971,Noun,1.00,618,678,1296
king,6592,3.8191,1688,3.2276,Noun,0.95,647,648,1295
artist,1460,3.1647,775,2.8899,Noun,1.00,647,646,1293
commander,1887,3.276,484,2.6857,Noun,0.99,665,628,1293
creator,142,2.1553,95,1.9823,Noun,1.00,641,652,1293
inventor,117,2.0719,83,1.9243,Noun,1.00,632,660,1292
philosopher,155,2.1931,114,2.0607,Noun,1.00,650,641,1291
critic,192,2.2856,126,2.1038,Noun,1.00,651,637,1288
uncle,6327,3.8013,1865,3.2709,Noun,1.00,620,668,1288
customer,775,2.8899,578,2.7627,Noun,1.00,629,655,1284
citizen,680,2.8331,515,2.7126,Noun,1.00,617,666,1283
son,20949,4.3212,5145,3.7115,Noun,1.00,612,671,1283
expert,1128,3.0527,842,2.9258,Noun,0.97,695,587,1282
man,94133,4.9737,8054,3.9061,Noun,1.00,613,669,1282
pilot,1360,3.1339,567,2.7543,Noun,0.95,632,650,1282
policeman,598,2.7774,386,2.5877,Noun,0.97,636,645,1281
girlfriend,3881,3.5891,1946,3.2894,Noun,1.00,620,659,1279
owner,1185,3.0741,850,2.9299,Noun,1.00,629,650,1279
hostess,189,2.2788,157,2.1987,Noun,1.00,613,665,1278
pedestrian,71,1.8573,56,1.7559,Noun,0.99,611,667,1278
